13,13,13,13,13,13,13,13,13,13,13,13,13,13,13
13,13,13,13,13,13,13,13,13,13,13,13,13,13,0
0,0,0,0,0,0,0,0,0,10,0,10,10,0,0
0,0,4,4,4,4,4,4,10,10,10,10,0,0,0
10,10,10,10,10,10,10,10,10,10,10,10,10,10,10
10,10,10,10,10,10,10,10,10,10,10,10,10,10,10
0,0,10,10,10,10,10,10,10,10,10,10,10,10,10
10,10,10,10,10,10,10,10,10,10,10,10,10,10,10
0,0,10,10,10,10,10,10,10,10,10,10,10,10,0
0,10,10,10,10,10,10,10,10,1,10,10,10,10,0
10,10,10,10,10,10,10,10,10,10,10,10,10,4,0
10,10,10,10,10,10,10,1,10,10,10,10,10,4,0
10,10,0,10,10,10,10,10,10,10,10,10,0,4,0
0,0,0,10,10,10,10,10,10,10,10,10,10,10,10
0,0,10,10,10,0,0,10,0,0,10,0,0,0,0
